SO   ./pics/wood.png

WE ./pics/bluestone.png

F 0,255,170

NO  ./pics/eagle.png

EA ./pics/redbrick.png

C 0,120,255



11111111111111111111111111111111111
10011111111100000000000011111111111
111100000010000111000000000000111 
1001000N00001000011101111111111111111
1111111001101101110000001000101110101
111101110000110000010100100011010111
11000000110101000000000010001000101
10000000000000000000000010001111111
10000000000000001001010010001000001
10000000000000001001010010001111111
10000000000000001101010010001000001
11000001110101011111011110011111111
11111111111111111111111111110000001
11111111111111111111111111111111111